###############
#_____________#
#_____________#
#_____________#
#_____________#
#_____________#
#_______#######
#_______#######
#_______#######
#______########
#______########
#______########
#____##########
#____##########
###############